XXXXOOOOOOXXCCC
OXXXOOOOOO**CCC
OXXOOOOOOO*OCCC
OO******OO****O
OO*OOOO*OOOOO*O
OO*OOOO**OOOO*O
OO****OO***OO*O
OXXOO*OOOO*OO*O
OOOOO*OOOO*OX*O
***OO*OO***OX*O
OO*OO*OO*OOOO*O
OX****OO*OOOO*O
OXXOOOOO******O
OOOOOOOOXOOOOOO
OOOOOOOXXXOOOOO