OOOXOOOOOOOOCCC
OXXXOOOOOO**CCC
OXXOOOOOOO*OCCC
OO******OO****O
OO*OOO8*OOOOO*O
OO*OOOO**OOOO*O
OO****OO***OO*O
OXXOO*OOOO*OO*O
OOOOO*OOOO*OO*O
***OO*OO***OO*O
OO*OO*OO*OOOO*O
OO****OO*OOOO*O
OXOOOOOO******O
OOOOOOOOXOOOOOO
OOOOOOOOOOOOOOO