XXXXXX*********
***OOX*OOXOOOO*
OO*OOO**XOOOOO*
OO*XOOO*XXXX***
OO*XXOO***OO*XO
OO*OXOOOO*OO*XO
OO*****OO*OO*XO
XOOOOO****OO*XO
XXXOOXXXOOOO*XO
XOXXOOO******XO
OOXXX***XOOXOOO
OX****OOOOOOCCC
OX*XOOOX****CCC
OO*XXXXX*XXXCCC
OO*******OOOOOX