XXXXXXXXXXXXXXX
XXXXXXXXXXXXXXX
XXXXXOOOXXXXXXX
XXXXOOOOOXXXXXX
XXXOOOOOOOXXXXX
XXOOOOOOOOOXXXX
XOOOOOOOOOOOCCC
************CCC
XOOOOOOOOOOOCCC
XXOOOOOOOOOXXXX
XXXOOOOOOOXXXXX
XXXXOOOOOXXXXXX
XXXXXOOOXXXXXXX
XXXXXXOXXXXXXXX
XXXXXXXXXXXXXXX